1 13 31
###############################
#p     ** *  1 *   *  * * *   #
# # # #*# # #*#*# # # #*#*#*# #
#   *  s  ***  *  1   *   * * #
# # # # # #*# # #*#*# # # # #*#
#   s     f  **  *  *   1     #
# # # # # # # # # #*# #*# # # #
#*  *   b  *  *   f  *        #
# # # # #*# # # #*#*# # # # # #
#*    **  *       *   f       #
# #*# # # # # # #*# # # # # # #
#   b   b   *   *  *          #
###############################